# TARGET GROUP = Amoebozoa
# AUTHOR = Kristen Swithers and Laura Katz
# SOURCE = this is essentially the NCBI taxonomy, which we are using just as a model for the exercise of enabling updates.

Alocodera	Hyalospheniidae
Amaurochaete	Stemonitidae
Amoeba	Amoebidae
Apodera	Hyalospheniidae
Arcella	Arcellidae
Arcellidae	Arcellina
Arcellina	Arcellinida
Arcellina	Arcellinida
Arcellinida	Tubulinea
Arcellinida	Tubulinea
Arcellinida incertae sedis	Arcellinida
Archamoebae	Amoebozoa
Arcyria	Trichiidae
Argynnia	Hyalospheniidae
Brefeldia	Stemonitidae
Bullinularia	Plagiopyxidae
Cavosteliaceae	Protosteliales
Cavostelium	Cavosteliaceae
Centropyxidae	Difflugina
Centropyxis	Centropyxidae
Ceratiomyxa	Ceratiomyxaceae
Ceratiomyxaceae	Protosteliales
Ceratiomyxella	Cavosteliaceae
Certesella	Hyalospheniidae
Chaos	Amoebidae
Clastostelium	Protosteliaceae
Colloderma	Stemonitidae
Comatricha	Stemonitidae
Cryptodifflugia	Cryptodifflugiidae
Cryptodifflugiidae	Phryganellina
Diachea	Stemonitidae
Diacheopsis	Stemonitida
Dianema	Dianemataceae
Dianemataceae	Trichiida
Difflugia	Difflugiidae
Difflugiidae	Difflugina
Difflugina	Arcellinida
Difflugina	Arcellinida
Echinamoeba	Echinamoebidae
Echinamoebidae	Euamoebida
Endostelium	Protosteliaceae
Enerthenema	Stemonitidae
Euamoebida	 Tubulinea
Filamoeba	Echinamoebidae
Flabellula	Flabellulidae
Flabellulidae	Leptomyxida
Gephyramoeba	Echinamoebidae
Glaeseria 	Hartmannellidae
Hartmannella	Hartmannellidae
Hartmannellidae	Tubulinida
Heleopera	Heleoperidae
Heleoperidae	Difflugina
Hemitrichia	Trichiidae
Hyalosphenia	Hyalospheniidae
Hyalospheniidae	Difflugina
Lamproderma	Stemonitidae
Leptomyxa 	Leptomyxidae
Leptomyxida	Euamoebida
Leptomyxidae	Leptomyxida
Lesquereusiidae	Difflugina
Macbrideola	Stemonitida
Mastigamoebidae	Archamoebae
Mastigella	Mastigamoebidae
Meriderma	Stemonitidae
Metatrichia	Trichiidae
Microchlamyiidae	Arcellina
Mycetozoa	Amoebozoa
Mycetozoa	Amoebozoa
Myxogastria	Mycetozoa
Nebela	Hyalospheniidae
Nematostelium	Protosteliaceae
Netzelia	Difflugiidae
Nolandella	Hartmannellidae
Paradiacheopsis	Stemonitidae
Paraflabellula	Flabellulidae
Perichaena	Trichiidae
Phalansterium	Amoebozoa
Phryganellina	Arcellinida
Physochila	Hyalospheniidae
Plagiopyxidae	Difflugina
Planoprotostelium	Cavosteliaceae
Porosia	Hyalospheniidae
Protosporangium	Cavosteliaceae
Protosteliaceae	Protosteliales
Protosteliales	Mycetozoa
Protosteliopsis	Protosteliaceae
Protostelium	Protosteliaceae
Pyxidicula	Tubulinea
Quadrulella	Lesquereusiidae
Rhizamoeba	Flabellulidae
Ripidomyxa	Flabellulidae
Saccamoeba	Hartmannellidae
Schizoplasmodiopsis	Protosteliaceae
Schizoplasmodium	Protosteliaceae
Soliformovum	Protosteliaceae
Spumochlamys	Microchlamyiidae
Stemonitida	Myxogastria
Stemonitida	Myxogastria
Stemonitida	Myxogastria
Stemonitidae	Stemonitida
Stemonitis	Stemonitidae
Stemonitopsis	Stemonitidae
Stereomyxa	Amoebozoa
Symphytocarpus	Stemonitida
Trichia	Trichiidae
Trichiida	Myxogastria
Trichiidae	Trichiida
Trichosidae	Arcellinida incertae sedis
Trichosphaerium	Trichosidae
Trigonopyxidae	Difflugina
Trigonopyxis	Trigonopyxidae
Tychosporium	Protosteliaceae
